[
  {
    "player": 30,
    "walls": [
      0, 1, 2, 3, 8, 11, 12, 13, 14, 15, 16, 23, 24, 31, 32, 33, 34, 37, 38, 39, 42, 43, 44, 45, -1,
      -1, -1, -1, -1, -1, -1, -1, -1, -1, -1, -1, -1, -1, -1, -1, -1, -1, -1, -1, -1, -1, -1, -1,
      -1, -1, -1, -1, -1, -1, -1, -1, -1, -1, -1, -1, -1, -1, -1, -1
    ],
    "blocks": [21, 26, -2, -3, -4, -5, -6, -7, -8, -9, -10, -11],
    "targets": [18, 29, -2, -3, -4, -5, -6, -7, -8, -9, -10, -11],
    "width": 8,
    "height": 6
  },
  {
    "player": 29,
    "walls": [
      2, 3, 4, 5, 10, 13, 16, 17, 18, 21, 22, 23, 24, 31, 32, 39, 40, 41, 42, 43, 44, 45, 46, 47,
      -1, -1, -1, -1, -1, -1, -1, -1, -1, -1, -1, -1, -1, -1, -1, -1, -1, -1, -1, -1, -1, -1, -1,
      -1, -1, -1, -1, -1, -1, -1, -1, -1, -1, -1, -1, -1, -1, -1, -1, -1
    ],
    "blocks": [26, -2, -3, -4, -5, -6, -7, -8, -9, -10, -11, -12],
    "targets": [28, -2, -3, -4, -5, -6, -7, -8, -9, -10, -11, -12],
    "width": 8,
    "height": 6
  },
  {
    "player": 18,
    "walls": [
      2, 3, 4, 5, 7, 8, 9, 12, 14, 19, 21, 26, 27, 28, 29, 30, 34, 37, 41, 44, 45, 46, 47, 48, -1,
      -1, -1, -1, -1, -1, -1, -1, -1, -1, -1, -1, -1, -1, -1, -1, -1, -1, -1, -1, -1, -1, -1, -1,
      -1, -1, -1, -1, -1, -1, -1, -1, -1, -1, -1, -1, -1, -1, -1, -1
    ],
    "blocks": [24, -2, -3, -4, -5, -6, -7, -8, -9, -10, -11, -12],
    "targets": [25, -2, -3, -4, -5, -6, -7, -8, -9, -10, -11, -12],
    "width": 7,
    "height": 7
  },
  {
    "player": 11,
    "walls": [
      1, 2, 3, 4, 5, 6, 7, 8, 9, 15, 16, 23, 24, 28, 29, 30, 31, 32, 33, 36, 41, 44, 49, 50, 51, 52,
      -1, -1, -1, -1, -1, -1, -1, -1, -1, -1, -1, -1, -1, -1, -1, -1, -1, -1, -1, -1, -1, -1, -1,
      -1, -1, -1, -1, -1, -1, -1, -1, -1, -1, -1, -1, -1, -1, -1
    ],
    "blocks": [18, 27, -2, -3, -4, -5, -6, -7, -8, -9, -10, -11],
    "targets": [19, 26, -2, -3, -4, -5, -6, -7, -8, -9, -10, -11],
    "width": 8,
    "height": 7
  },
  {
    "player": 25,
    "walls": [
      2, 3, 4, 5, 9, 12, 14, 15, 16, 19, 21, 26, 27, 28, 34, 35, 36, 37, 41, 44, 45, 46, 47, 48, -1,
      -1, -1, -1, -1, -1, -1, -1, -1, -1, -1, -1, -1, -1, -1, -1, -1, -1, -1, -1, -1, -1, -1, -1,
      -1, -1, -1, -1, -1, -1, -1, -1, -1, -1, -1, -1, -1, -1, -1, -1
    ],
    "blocks": [31, -2, -3, -4, -5, -6, -7, -8, -9, -10, -11, -12],
    "targets": [32, -2, -3, -4, -5, -6, -7, -8, -9, -10, -11, -12],
    "width": 7,
    "height": 7
  },
  {
    "player": 25,
    "walls": [
      2, 3, 4, 5, 9, 12, 16, 19, 21, 22, 23, 26, 27, 28, 34, 35, 41, 42, 43, 46, 47, 48, 50, 51, 52,
      53, -1, -1, -1, -1, -1, -1, -1, -1, -1, -1, -1, -1, -1, -1, -1, -1, -1, -1, -1, -1, -1, -1,
      -1, -1, -1, -1, -1, -1, -1, -1, -1, -1, -1, -1, -1, -1, -1, -1
    ],
    "blocks": [31, -2, -3, -4, -5, -6, -7, -8, -9, -10, -11, -12],
    "targets": [32, -2, -3, -4, -5, -6, -7, -8, -9, -10, -11, -12],
    "width": 7,
    "height": 8
  },
  {
    "player": 28,
    "walls": [
      2, 3, 4, 5, 6, 7, 10, 15, 16, 17, 18, 23, 24, 29, 30, 31, 32, 37, 40, 41, 42, 45, 50, 51, 52,
      53, -1, -1, -1, -1, -1, -1, -1, -1, -1, -1, -1, -1, -1, -1, -1, -1, -1, -1, -1, -1, -1, -1,
      -1, -1, -1, -1, -1, -1, -1, -1, -1, -1, -1, -1, -1, -1, -1, -1
    ],
    "blocks": [35, -2, -3, -4, -5, -6, -7, -8, -9, -10, -11, -12],
    "targets": [36, -2, -3, -4, -5, -6, -7, -8, -9, -10, -11, -12],
    "width": 8,
    "height": 7
  },
  {
    "player": 24,
    "walls": [
      1, 2, 3, 4, 5, 6, 8, 13, 14, 15, 20, 21, 27, 28, 31, 34, 35, 38, 39, 40, 41, 42, 43, 44, 45,
      -1, -1, -1, -1, -1, -1, -1, -1, -1, -1, -1, -1, -1, -1, -1, -1, -1, -1, -1, -1, -1, -1, -1,
      -1, -1, -1, -1, -1, -1, -1, -1, -1, -1, -1, -1, -1, -1, -1, -1
    ],
    "blocks": [16, 30, -2, -3, -4, -5, -6, -7, -8, -9, -10, -11],
    "targets": [18, 32, -2, -3, -4, -5, -6, -7, -8, -9, -10, -11],
    "width": 7,
    "height": 7
  },
  {
    "player": 14,
    "walls": [
      0, 1, 2, 3, 6, 9, 12, 15, 18, 21, 22, 23, 24, 29, 30, 33, 35, 36, 37, 41, 43, 44, 45, 46, 47,
      -1, -1, -1, -1, -1, -1, -1, -1, -1, -1, -1, -1, -1, -1, -1, -1, -1, -1, -1, -1, -1, -1, -1,
      -1, -1, -1, -1, -1, -1, -1, -1, -1, -1, -1, -1, -1, -1, -1, -1
    ],
    "blocks": [20, 32, -2, -3, -4, -5, -6, -7, -8, -9, -10, -11],
    "targets": [19, 31, -2, -3, -4, -5, -6, -7, -8, -9, -10, -11],
    "width": 6,
    "height": 8
  },
  {
    "player": 18,
    "walls": [
      2, 3, 4, 5, 7, 8, 9, 12, 14, 19, 21, 26, 27, 28, 29, 30, 34, 37, 41, 44, 45, 46, 47, 48, -1,
      -1, -1, -1, -1, -1, -1, -1, -1, -1, -1, -1, -1, -1, -1, -1, -1, -1, -1, -1, -1, -1, -1, -1,
      -1, -1, -1, -1, -1, -1, -1, -1, -1, -1, -1, -1, -1, -1, -1, -1
    ],
    "blocks": [17, 24, -2, -3, -4, -5, -6, -7, -8, -9, -10, -11],
    "targets": [39, 40, -2, -3, -4, -5, -6, -7, -8, -9, -10, -11],
    "width": 7,
    "height": 7
  },
  {
    "player": 12,
    "walls": [
      0, 1, 2, 3, 4, 5, 6, 7, 8, 15, 16, 23, 24, 25, 26, 29, 30, 31, 34, 37, 42, 43, 44, 45, -1, -1,
      -1, -1, -1, -1, -1, -1, -1, -1, -1, -1, -1, -1, -1, -1, -1, -1, -1, -1, -1, -1, -1, -1, -1,
      -1, -1, -1, -1, -1, -1, -1, -1, -1, -1, -1, -1, -1, -1, -1
    ],
    "blocks": [11, 19, -2, -3, -4, -5, -6, -7, -8, -9, -10, -11],
    "targets": [10, 21, -2, -3, -4, -5, -6, -7, -8, -9, -10, -11],
    "width": 8,
    "height": 6
  },
  {
    "player": 29,
    "walls": [
      2, 3, 4, 5, 10, 13, 16, 17, 18, 21, 22, 23, 24, 31, 32, 39, 40, 41, 42, 43, 44, 45, 46, 47,
      -1, -1, -1, -1, -1, -1, -1, -1, -1, -1, -1, -1, -1, -1, -1, -1, -1, -1, -1, -1, -1, -1, -1,
      -1, -1, -1, -1, -1, -1, -1, -1, -1, -1, -1, -1, -1, -1, -1, -1, -1
    ],
    "blocks": [26, 27, -2, -3, -4, -5, -6, -7, -8, -9, -10, -11],
    "targets": [37, 38, -2, -3, -4, -5, -6, -7, -8, -9, -10, -11],
    "width": 8,
    "height": 6
  },
  {
    "player": 18,
    "walls": [
      2, 3, 4, 5, 6, 7, 8, 9, 13, 14, 20, 21, 27, 28, 29, 32, 33, 34, 36, 39, 43, 44, 45, 46, -1,
      -1, -1, -1, -1, -1, -1, -1, -1, -1, -1, -1, -1, -1, -1, -1, -1, -1, -1, -1, -1, -1, -1, -1,
      -1, -1, -1, -1, -1, -1, -1, -1, -1, -1, -1, -1, -1, -1, -1, -1
    ],
    "blocks": [23, 24, -2, -3, -4, -5, -6, -7, -8, -9, -10, -11],
    "targets": [17, 30, -2, -3, -4, -5, -6, -7, -8, -9, -10, -11],
    "width": 7,
    "height": 7
  },
  {
    "player": 27,
    "walls": [
      1, 2, 3, 4, 9, 12, 17, 20, 24, 25, 28, 32, 36, 37, 38, 39, 40, 47, 48, 49, 50, 51, 55, 59, 60,
      61, 62, 63, -1, -1, -1, -1, -1, -1, -1, -1, -1, -1, -1, -1, -1, -1, -1, -1, -1, -1, -1, -1,
      -1, -1, -1, -1, -1, -1, -1, -1, -1, -1, -1, -1, -1, -1, -1, -1
    ],
    "blocks": [26, 34, -2, -3, -4, -5, -6, -7, -8, -9, -10, -11],
    "targets": [19, 43, -2, -3, -4, -5, -6, -7, -8, -9, -10, -11],
    "width": 8,
    "height": 8
  },
  {
    "player": 27,
    "walls": [
      1, 2, 3, 4, 5, 7, 11, 12, 13, 17, 18, 22, 23, 24, 28, 30, 33, 34, 36, 39, 42, 43, 44, 45, -1,
      -1, -1, -1, -1, -1, -1, -1, -1, -1, -1, -1, -1, -1, -1, -1, -1, -1, -1, -1, -1, -1, -1, -1,
      -1, -1, -1, -1, -1, -1, -1, -1, -1, -1, -1, -1, -1, -1, -1, -1
    ],
    "blocks": [20, 21, -2, -3, -4, -5, -6, -7, -8, -9, -10, -11],
    "targets": [25, 26, -2, -3, -4, -5, -6, -7, -8, -9, -10, -11],
    "width": 6,
    "height": 8
  },
  {
    "player": 28,
    "walls": [
      1, 2, 3, 4, 5, 6, 7, 8, 9, 15, 16, 23, 24, 29, 30, 31, 32, 37, 40, 41, 42, 43, 44, 45, -1, -1,
      -1, -1, -1, -1, -1, -1, -1, -1, -1, -1, -1, -1, -1, -1, -1, -1, -1, -1, -1, -1, -1, -1, -1,
      -1, -1, -1, -1, -1, -1, -1, -1, -1, -1, -1, -1, -1, -1, -1
    ],
    "blocks": [18, 20, -2, -3, -4, -5, -6, -7, -8, -9, -10, -11],
    "targets": [11, 27, -2, -3, -4, -5, -6, -7, -8, -9, -10, -11],
    "width": 8,
    "height": 6
  },
  {
    "player": 36,
    "walls": [
      2, 3, 4, 5, 10, 13, 14, 15, 16, 17, 18, 23, 24, 31, 32, 37, 38, 39, 40, 45, 48, 49, 50, 51,
      52, 53, -1, -1, -1, -1, -1, -1, -1, -1, -1, -1, -1, -1, -1, -1, -1, -1, -1, -1, -1, -1, -1,
      -1, -1, -1, -1, -1, -1, -1, -1, -1, -1, -1, -1, -1, -1, -1, -1, -1
    ],
    "blocks": [20, 27, 29, -2, -3, -4, -5, -6, -7, -8, -9, -10],
    "targets": [19, 21, 28, -2, -3, -4, -5, -6, -7, -8, -9, -10],
    "width": 8,
    "height": 7
  },
  {
    "player": 30,
    "walls": [
      2, 3, 4, 5, 9, 12, 16, 19, 21, 22, 23, 26, 28, 33, 34, 35, 37, 41, 42, 48, 49, 50, 51, 52, 53,
      54, 55, -1, -1, -1, -1, -1, -1, -1, -1, -1, -1, -1, -1, -1, -1, -1, -1, -1, -1, -1, -1, -1,
      -1, -1, -1, -1, -1, -1, -1, -1, -1, -1, -1, -1, -1, -1, -1, -1
    ],
    "blocks": [24, 32, 38, -2, -3, -4, -5, -6, -7, -8, -9, -10],
    "targets": [25, 31, 39, -2, -3, -4, -5, -6, -7, -8, -9, -10],
    "width": 7,
    "height": 8
  },
  {
    "player": 29,
    "walls": [
      2, 3, 4, 5, 9, 12, 14, 15, 16, 19, 21, 26, 28, 33, 34, 35, 36, 41, 43, 48, 50, 51, 52, 53, 54,
      55, -1, -1, -1, -1, -1, -1, -1, -1, -1, -1, -1, -1, -1, -1, -1, -1, -1, -1, -1, -1, -1, -1,
      -1, -1, -1, -1, -1, -1, -1, -1, -1, -1, -1, -1, -1, -1, -1, -1
    ],
    "blocks": [32, -2, -3, -4, -5, -6, -7, -8, -9, -10, -11, -12],
    "targets": [30, -2, -3, -4, -5, -6, -7, -8, -9, -10, -11, -12],
    "width": 7,
    "height": 8
  },
  {
    "player": 46,
    "walls": [
      1, 2, 3, 4, 9, 12, 17, 20, 25, 28, 29, 30, 31, 32, 33, 34, 39, 40, 47, 48, 53, 54, 55, 56, 57,
      58, 59, 60, 61, -1, -1, -1, -1, -1, -1, -1, -1, -1, -1, -1, -1, -1, -1, -1, -1, -1, -1, -1,
      -1, -1, -1, -1, -1, -1, -1, -1, -1, -1, -1, -1, -1, -1, -1, -1
    ],
    "blocks": [35, 36, -2, -3, -4, -5, -6, -7, -8, -9, -10, -11],
    "targets": [44, 52, -2, -3, -4, -5, -6, -7, -8, -9, -10, -11],
    "width": 8,
    "height": 8
  },
  {
    "player": 45,
    "walls": [
      1, 2, 3, 4, 8, 11, 12, 13, 15, 20, 21, 22, 27, 28, 32, 33, 34, 35, 39, 42, 46, 49, 50, 51, 52,
      53, -1, -1, -1, -1, -1, -1, -1, -1, -1, -1, -1, -1, -1, -1, -1, -1, -1, -1, -1, -1, -1, -1,
      -1, -1, -1, -1, -1, -1, -1, -1, -1, -1, -1, -1, -1, -1, -1, -1
    ],
    "blocks": [23, 30, 37, -2, -3, -4, -5, -6, -7, -8, -9, -10],
    "targets": [17, 18, 19, -2, -3, -4, -5, -6, -7, -8, -9, -10],
    "width": 7,
    "height": 8
  },
  {
    "player": 27,
    "walls": [
      1, 2, 3, 4, 5, 6, 7, 8, 9, 15, 16, 23, 24, 26, 29, 30, 31, 32, 37, 40, 41, 42, 43, 44, 45, -1,
      -1, -1, -1, -1, -1, -1, -1, -1, -1, -1, -1, -1, -1, -1, -1, -1, -1, -1, -1, -1, -1, -1, -1,
      -1, -1, -1, -1, -1, -1, -1, -1, -1, -1, -1, -1, -1, -1, -1
    ],
    "blocks": [19, 20, -2, -3, -4, -5, -6, -7, -8, -9, -10, -11],
    "targets": [12, 34, -2, -3, -4, -5, -6, -7, -8, -9, -10, -11],
    "width": 8,
    "height": 6
  },
  {
    "player": -1,
    "walls": [
      0, 1, 2, 3, 4, 8, 12, 16, 20, 21, 22, 23, 24, 25, 31, 33, 39, 41, 44, 45, 46, 47, 49, 52, 57,
      58, 59, 60, -1, -1, -1, -1, -1, -1, -1, -1, -1, -1, -1, -1, -1, -1, -1, -1, -1, -1, -1, -1,
      -1, -1, -1, -1, -1, -1, -1, -1, -1, -1, -1, -1, -1, -1, -1, -1
    ],
    "blocks": [26, 27, 29, -2, -3, -4, -5, -6, -7, -8, -9, -10],
    "targets": [35, 37, -2, -3, -4, -5, -6, -7, -8, -9, -10],
    "width": 8,
    "height": 8
  },
  {
    "player": -1,
    "walls": [
      0, 1, 2, 3, 4, 5, 6, 7, 8, 11, 15, 16, 23, 24, 28, 29, 30, 31, 32, 37, 40, 41, 42, 43, 44, 45,
      -1, -1, -1, -1, -1, -1, -1, -1, -1, -1, -1, -1, -1, -1, -1, -1, -1, -1, -1, -1, -1, -1, -1,
      -1, -1, -1, -1, -1, -1, -1, -1, -1, -1, -1, -1, -1, -1, -1
    ],
    "blocks": [25, 26, 27, -2, -3, -4, -5, -6, -7, -8, -9, -10],
    "targets": [34, 36, -2, -3, -4, -5, -6, -7, -8, -9, -10],
    "width": 8,
    "height": 6
  },
  {
    "player": 18,
    "walls": [
      0, 1, 2, 3, 4, 5, 6, 7, 13, 14, 20, 21, 22, 27, 29, 32, 33, 34, 36, 39, 43, 44, 45, 46, -1,
      -1, -1, -1, -1, -1, -1, -1, -1, -1, -1, -1, -1, -1, -1, -1, -1, -1, -1, -1, -1, -1, -1, -1,
      -1, -1, -1, -1, -1, -1, -1, -1, -1, -1, -1, -1, -1, -1, -1, -1
    ],
    "blocks": [16, 23, 24, -2, -3, -4, -5, -6, -7, -8, -9, -10],
    "targets": [11, 12, 19, -2, -3, -4, -5, -6, -7, -8, -9, -10],
    "width": 7,
    "height": 7
  },
  {
    "player": 35,
    "walls": [
      2, 3, 4, 5, 10, 13, 16, 17, 18, 21, 22, 23, 24, 31, 32, 39, 40, 41, 45, 46, 47, 49, 50, 51,
      52, 53, -1, -1, -1, -1, -1, -1, -1, -1, -1, -1, -1, -1, -1, -1, -1, -1, -1, -1, -1, -1, -1,
      -1, -1, -1, -1, -1, -1, -1, -1, -1, -1, -1, -1, -1, -1, -1, -1, -1
    ],
    "blocks": [26, 29, -2, -3, -4, -5, -6, -7, -8, -9, -10, -11],
    "targets": [34, 37, -2, -3, -4, -5, -6, -7, -8, -9, -10, -11],
    "width": 8,
    "height": 7
  },
  {
    "player": 33,
    "walls": [
      0, 1, 2, 3, 8, 11, 16, 19, 20, 21, 22, 23, 24, 31, 32, 39, 40, 41, 44, 45, 46, 47, 49, 52, 57,
      58, 59, 60, -1, -1, -1, -1, -1, -1, -1, -1, -1, -1, -1, -1, -1, -1, -1, -1, -1, -1, -1, -1,
      -1, -1, -1, -1, -1, -1, -1, -1, -1, -1, -1, -1, -1, -1, -1, -1
    ],
    "blocks": [26, 27, 29, -2, -3, -4, -5, -6, -7, -8, -9, -10],
    "targets": [34, 35, 37, -2, -3, -4, -5, -6, -7, -8, -9, -10],
    "width": 8,
    "height": 8
  },
  {
    "player": 14,
    "walls": [
      0, 1, 2, 3, 4, 5, 6, 9, 15, 16, 17, 18, 26, 27, 35, 36, 37, 38, 39, 40, 41, 44, 50, 51, 52,
      53, -1, -1, -1, -1, -1, -1, -1, -1, -1, -1, -1, -1, -1, -1, -1, -1, -1, -1, -1, -1, -1, -1,
      -1, -1, -1, -1, -1, -1, -1, -1, -1, -1, -1, -1, -1, -1, -1, -1
    ],
    "blocks": [31, -2, -3, -4, -5, -6, -7, -8, -9, -10, -11, -12],
    "targets": [13, -2, -3, -4, -5, -6, -7, -8, -9, -10, -11, -12],
    "width": 9,
    "height": 6
  }
]
